###################
#     #      #    #
#  #        ###   #
H  #  ##   #      #
#K   #       #    #
###################
